{
    "map": [
        0, 0, 0, 0, 0, 0, 0, 0, 0, 0, 0, 0, 0,
        0, 0, 0, 0, 0, 0, 2, 0, 0, 0, 0, 0, 0,
        0, 0, 0, 0, 0, 0, 3, 0, 0, 0, 0, 0, 0,
        0, 0, 0, 0, 0, 0, 3, 0, 0, 0, 0, 0, 0,
        0, 0, 0, 0, 0, 0, 3, 0, 0, 0, 0, 0, 0,
        0, 0, 0, 0, 0, 0, 3, 0, 0, 0, 0, 0, 0,
        0, 1, 3, 3, 3, 3, 2, 3, 3, 3, 3, 1, 0,
        0, 0, 0, 0, 0, 0, 0, 0, 0, 0, 0, 0, 0
    ],
    "mapWidth": 13,
    "moves": [
        1, 0,
        2, 2,
        2, 1,
        2, 1,
        4, 3,
        5, 0
    ],
    "startPos": {
        "x": 1,
        "y": 6
    },
    "targets": [
        6, 1,
        6, 11
    ], 
    "direction": "down"
}
