{
    "map": [
        0, 0, 0, 0, 0, 0, 0, 0,
        0, 2, 0, 0, 0, 0, 0, 0,
        0, 2, 0, 0, 0, 0, 0, 0,
        0, 2, 0, 0, 0, 0, 0, 0,
        0, 2, 0, 0, 0, 0, 0, 0,
        0, 2, 0, 0, 0, 0, 0, 0,
        0, 2, 0, 0, 0, 0, 0, 0,
        0, 2, 0, 0, 0, 0, 0, 0,
        0, 3, 2, 0, 0, 0, 0, 0,
        0, 0, 2, 2, 0, 0, 0, 0,
        0, 0, 0, 2, 2, 0, 0, 0,
        0, 0, 0, 0, 2, 2, 0, 0,
        0, 0, 0, 0, 0, 2, 2, 0,
        0, 0, 0, 0, 0, 0, 2, 0,
        0, 0, 0, 0, 0, 0, 0, 0
    ],
    "mapWidth": 8,
    "moves": [
        1, 2,
        5, 2,
        3, 0,
        1, 0,
        2, 2,
        1, 2
    ],
    "startPos": {
        "x": 1,
        "y": 1
    },
    "targets": [
        13, 6
    ], 
    "direction": "down"
}
