{
    "map": [
        0, 0, 0, 0, 0, 0, 0, 0, 0, 0, 0, 0, 0, 0, 0, 0, 0, 0,
        0, 2, 1, 1, 1, 1, 0, 2, 1, 2, 0, 3, 2, 2, 2, 2, 3, 0,
        0, 1, 0, 0, 0, 0, 0, 1, 0, 1, 0, 2, 0, 0, 0, 0, 2, 0,
        0, 2, 1, 1, 1, 1, 1, 1, 1, 2, 0, 2, 0, 0, 0, 0, 2, 0,
        0, 0, 0, 0, 0, 0, 0, 3, 0, 0, 0, 2, 0, 0, 0, 0, 2, 0,
        0, 2, 1, 2, 0, 1, 3, 3, 3, 3, 3, 2, 2, 2, 2, 2, 3, 0,
        0, 1, 0, 1, 0, 3, 0, 3, 0, 0, 0, 1, 0, 0, 0, 0, 0, 0,
        0, 1, 0, 1, 0, 3, 0, 3, 0, 0, 0, 1, 0, 0, 0, 0, 0, 0,
        0, 1, 0, 1, 0, 1, 3, 1, 0, 0, 0, 1, 0, 0, 0, 0, 0, 0,
        0, 0, 0, 2, 0, 0, 0, 0, 0, 0, 0, 1, 0, 0, 0, 0, 0, 0,
        0, 3, 2, 2, 2, 2, 3, 3, 3, 3, 3, 1, 1, 1, 1, 1, 2, 0,
        0, 2, 0, 2, 0, 0, 0, 0, 0, 0, 0, 1, 0, 0, 0, 0, 1, 0,
        0, 3, 2, 3, 0, 0, 0, 0, 0, 0, 0, 2, 1, 1, 1, 1, 2, 0,
        0, 0, 0, 0, 0, 0, 0, 0, 0, 0, 0, 0, 0, 0, 0, 0, 0, 0
    ],
    "mapWidth": 18,
    "movesf1": [
        1, 0,
        3, 2,
        8, 3,
        7, 0
    ],
    "movesf2": [
        1, 0,
        2, 1,
        9, 2,
        8, 0
    ],
    "movesf3": [
        1, 0,
        3, 3,
        7, 1,
        9, 0
    ],
    "startPos": {
        "x": 1,
        "y": 5
    },
    "targets": [
        8, 1
    ],
    "direction": "left"
}
