{
    "map": [
        0, 0, 0, 0, 0, 0, 0, 0, 0, 0, 0, 0, 0,
        0, 0, 0, 0, 0, 0, 0, 0, 0, 0, 0, 3, 0,
        0, 0, 0, 0, 0, 0, 0, 0, 0, 0, 0, 3, 0,
        0, 2, 3, 3, 3, 3, 3, 3, 3, 2, 0, 3, 0,
        0, 3, 0, 0, 0, 0, 0, 0, 0, 3, 0, 3, 0,
        0, 3, 0, 2, 3, 3, 3, 2, 0, 3, 0, 3, 0,
        0, 3, 0, 3, 0, 0, 0, 3, 0, 3, 0, 3, 0,
        0, 3, 0, 3, 0, 2, 1, 2, 0, 3, 0, 3, 0,
        0, 3, 0, 3, 0, 3, 0, 0, 0, 3, 0, 3, 0,
        0, 3, 0, 3, 0, 2, 3, 3, 3, 2, 0, 3, 0,
        0, 3, 0, 3, 0, 0, 0, 0, 0, 0, 0, 3, 0,
        0, 3, 0, 2, 3, 3, 3, 3, 3, 3, 3, 2, 0,
        0, 3, 0, 0, 0, 0, 0, 0, 0, 0, 0, 0, 0,
        0, 3, 0, 0, 0, 0, 0, 0, 0, 0, 0, 0, 0,
        0, 0, 0, 0, 0, 0, 0, 0, 0, 0, 0, 0, 0
    ],
    "mapWidth": 13,
    "colors": [13, 14, 15, 4, 5, 6, 8, 9, 10],
    "movesf1": [
        1, 3,
        2, 2,
        1, 2,
        1, 1,
        7, 3,
        3, 2,
        1, 0,
        1, 3
    ],
    "startPos": {
        "x": 13,
        "y": 1
    },
    "targets": [
        1, 11
    ],
    "direction": "up"
}
