{
    "map": [
        0, 0, 0, 0, 0, 0, 0, 0, 0, 0, 0, 0, 0, 0, 0, 0, 0, 0, 
        0, 1, 3, 3, 3, 3, 0, 1, 3, 1, 0, 2, 1, 1, 1, 1, 2, 0, 
        0, 3, 0, 0, 0, 0, 0, 3, 0, 3, 0, 1, 0, 0, 0, 0, 1, 0, 
        0, 1, 3, 3, 3, 3, 3, 3, 3, 1, 0, 1, 0, 0, 0, 0, 1, 0, 
        0, 0, 0, 0, 0, 0, 0, 2, 0, 0, 0, 1, 0, 0, 0, 0, 1, 0, 
        0, 1, 3, 1, 0, 3, 2, 2, 2, 2, 2, 1, 1, 1, 1, 1, 2, 0, 
        0, 3, 0, 3, 0, 2, 0, 2, 0, 0, 0, 3, 0, 0, 0, 0, 0, 0, 
        0, 3, 0, 3, 0, 2, 0, 2, 0, 0, 0, 3, 0, 0, 0, 0, 0, 0, 
        0, 3, 0, 3, 0, 3, 2, 3, 0, 0, 0, 3, 0, 0, 0, 0, 0, 0, 
        0, 0, 0, 1, 0, 0, 0, 0, 0, 0, 0, 3, 0, 0, 0, 0, 0, 0, 
        0, 2, 1, 1, 1, 1, 2, 2, 2, 2, 2, 3, 3, 3, 3, 3, 1, 0, 
        0, 1, 0, 1, 0, 0, 0, 0, 0, 0, 0, 3, 0, 0, 0, 0, 3, 0, 
        0, 2, 1, 2, 0, 0, 0, 0, 0, 0, 0, 1, 3, 3, 3, 3, 1, 0, 
        0, 0, 0, 0, 0, 0, 0, 0, 0, 0, 0, 0, 0, 0, 0, 0, 0, 0
    ],
    "mapWidth": 18,
    "cameraPos": {
        "x": 17,
        "y": 24.3,
        "z": -45.7
    },
    "cameraSize": 28,
    "colors": [13, 14, 15],
    "movesf1": [
        1, 3,
        3, 1,
        7, 3,
        8, 0
    ],
    "movesf2": [
        1, 2,
        2, 3,
        8, 2,
        9, 0
    ],
    "movesf3": [
        1, 1,
        3, 2,
        9, 1,
        7, 0
    ],
    "startPos": {
        "x": 1,
        "y": 5
    },
    "targets": [       
        1, 1,
        1, 7,
        1, 9,
        1, 11,
        1, 16,
        3, 1,
        3, 9,
        5, 1,
        5, 3,
        5, 5,
        5, 16,
        8, 1,
        8, 7,
        8, 5,
        10, 1,
        10, 16,
        12, 1,
        12, 3,
        12, 11,
        12, 16        
    ],
    "direction": "left"
}
