{
    "map": [
        0, 0, 0, 0, 0, 0, 0, 0, 0, 0, 0, 0, 0, 0, 0, 0, 0, 0,
        0, 0, 0, 0, 2, 0, 0, 0, 0, 2, 0, 0, 0, 0, 0, 2, 0, 0,
        0, 0, 2, 0, 3, 0, 0, 0, 0, 3, 0, 2, 3, 3, 3, 1, 2, 0,
        0, 2, 1, 3, 1, 3, 3, 3, 3, 1, 3, 1, 3, 3, 3, 1, 2, 0,
        0, 0, 3, 0, 3, 0, 0, 0, 0, 3, 0, 3, 0, 0, 0, 3, 0, 0,
        0, 0, 3, 0, 3, 0, 0, 0, 0, 3, 0, 3, 0, 2, 0, 3, 0, 0,
        0, 2, 1, 2, 3, 0, 0, 0, 0, 3, 0, 3, 0, 3, 0, 2, 0, 0,
        0, 0, 3, 0, 3, 2, 0, 0, 2, 1, 2, 2, 2, 1, 3, 2, 0, 0,
        0, 0, 2, 0, 2, 3, 0, 0, 0, 3, 0, 0, 0, 3, 0, 2, 0, 0,
        0, 0, 2, 0, 0, 3, 0, 0, 0, 3, 0, 0, 0, 3, 2, 1, 2, 0,
        0, 2, 1, 3, 3, 1, 3, 3, 3, 1, 3, 3, 3, 1, 3, 1, 2, 0,
        0, 0, 3, 0, 0, 3, 0, 0, 0, 3, 0, 0, 0, 3, 0, 3, 0, 0,
        0, 0, 2, 0, 0, 3, 0, 0, 0, 3, 0, 0, 0, 3, 0, 2, 0, 0,
        0, 0, 0, 0, 0, 3, 0, 0, 0, 3, 0, 0, 2, 1, 3, 2, 0, 0,
        0, 0, 0, 0, 2, 1, 2, 0, 0, 3, 0, 0, 0, 3, 0, 0, 0, 0,
        0, 0, 0, 0, 0, 3, 0, 0, 0, 3, 0, 0, 0, 2, 0, 0, 0, 0,
        0, 0, 0, 0, 0, 2, 0, 0, 0, 3, 0, 0, 0, 0, 0, 0, 0, 0,
        0, 0, 0, 0, 0, 0, 0, 0, 0, 0, 0, 0, 0, 0, 0, 0, 0, 0
    ],
    "mapWidth": 18,
    "cameraPos": {
        "x": 17,
        "y": 9.5,
        "z": -31.8
    },
    "cameraSize": 28,
    "colors": [14, 15],
    "movesf1": [
        1, 0,
        3, 0,
        2, 3,
        3, 2,
        7, 0
    ],
    "startPos": {
        "x": 16,
        "y": 9
    },
    "targets": [       
        3, 1,
        6, 1,
        10, 1,
        2, 2,
        8, 2,
        9, 2,
        12, 2,
        6, 3,
        1, 4,
        8, 4,
        14, 4,
        7, 5,
        16, 5,
        14, 6,
        7, 8,
        1, 9,
        7, 10,
        2, 11,
        7, 11,
        7, 12,
        13, 12,
        5, 13,
        15, 13,
        9, 14,
        1, 15,
        6, 15,
        7, 15,
        8, 15,
        12, 15,
        13, 15,
        2, 16,
        3, 16,
        9, 16,
        10, 16


















    ],
    "direction": "up"
}
